1 1 1 1 1 1 1 1 1 1
1 0 0 0 0 0 0 0 1 1
1 0 0 0 0 0 0 1 1 1
1 0 0 0 0 0 - 0 0 1
1 0 0 0 - 0 0 0 0 1
1 0 0 0 0 0 0 0 0 1
1 - - 0 0 0 0 0 0 1
1 0 0 0 0 - - - 0 1
1 1 0 0 0 0 0 0 0 1
1 1 1 1 1 1 1 1 1 1

===================
0 -> background
1 -> wall
- -> platform
E -> exit door
S -> entry door